################
#X@            #
# #            #
# #          # #
# #          # #
# #          # #
# #        s # #
# #          # #
# #          # #
# #          # #
# #          # #
# #          # #
# #          # #
# ############ #
#              #
################
